Abattoir Ghoul	Creature
Abbey Griffin	Creature
Abrupt Decay	Instant
Abuna Acolyte	Creature
Abundant Growth	Unknown
Accorder Paladin	Creature
Accorder's Shield	Unknown
Acid Web Spider	Creature
Acidic Slime	Creature
Acolyte of Xathrid	Creature
Act of Treason	Sorcery
Adventuring Gear	Unknown
Aegis Angel	Creature
Aerial Predation	Instant
Affa Guard Hound	Creature
Afflicted Deserter	Creature
Aggravate	Instant
Air Elemental	Creature
Air Servant	Creature
Ajani's Mantra	Unknown
Ajani's Pridemate	Creature
Ajani's Sunstriker	Creature
Akoum Boulderfoot	Creature
Akoum Refuge	Land
Alabaster Mage	Creature
Alchemist's Apprentice	Creature
Alchemist's Refuge	Land
Alluring Siren	Creature
Alpha Brawl	Sorcery
Alpha Tyrranax	Creature
Altar of the Lost	Unknown
Altar's Reap	Instant
Amass the Components	Sorcery
Ambush Viper	Creature
Amphin Cutthroat	Creature
Ancient Grudge	Instant
Ancient Hellkite	Creature
Ancient Stirrings	Sorcery
Angel of Flight Alabaster	Creature
Angel of Glory's Rise	Creature
Angel of Jubilation	Creature
Angel of Serenity	Creature
Angel's Feather	Unknown
Angel's Mercy	Instant
Angel's Tomb	Unknown
Angelheart Vial	Unknown
Angelic Arbiter	Creature
Angelic Armaments	Unknown
Angelic Benediction	Unknown
Angelic Destiny	Unknown
Angelic Overseer	Creature
Angelic Wall	Creature
Annihilating Fire	Instant
Ant Queen	Creature
Appetite for Brains	Sorcery
Aquus Steed	Creature
Arachnus Spinner	Creature
Arachnus Web	Unknown
Arbalest Elite	Creature
Arbor Elf	Creature
Arc Runner	Creature
Arc Trail	Sorcery
Arcane Melee	Unknown
Archaeomancer	Creature
Archangel	Creature
Archangel's Light	Sorcery
Archdemon of Greed	Creature
Archive Trap	Instant
Archmage Ascension	Unknown
Archon of Justice	Creature
Archon of the Triumvirate	Creature
Archweaver	Creature
Archwing Dragon	Creature
Arctic Aven	Creature
Ardent Recruit	Creature
Argent Mutation	Instant
Argent Sphinx	Creature
Argentum Armor	Unknown
Arid Mesa	Land
Arm with Ã†ther	Sorcery
Armada Wurm	Creature
Armament Master	Creature
Armored Ascension	Unknown
Armored Cancrix	Creature
Armored Skaab	Creature
Armored Warhorse	Creature
Armory Guard	Creature
Arms Dealer	Creature
Army of the Damned	Sorcery
Arrest	Unknown
Arrogant Bloodlord	Creature
Arrow Volley Trap	Instant
Artful Dodge	Sorcery
Artillerize	Instant
Artisan of Kozilek	Creature
Asceticism	Unknown
Ash Zealot	Creature
Ashmouth Hound	Creature
Assassin's Strike	Sorcery
Assassinate	Sorcery
Assault Griffin	Creature
Assault Strobe	Sorcery
Attended Knight	Creature
Auger Spree	Instant
Augur of Bolas	Creature
Augury Owl	Creature
Aura Finesse	Instant
Aura Gnarlid	Creature
Auramancer	Creature
Auriok Edgewright	Creature
Auriok Sunchaser	Creature
Auriok Survivors	Creature
Autumn's Veil	Instant
Avacyn's Collar	Unknown
Avacyn's Pilgrim	Creature
Avacynian Priest	Creature
Aven Fleetwing	Creature
Aven Squire	Creature
Avenging Arrow	Instant
Awakener Druid	Creature
Awakening Zone	Unknown
Axebane Guardian	Creature
Axebane Stag	Creature
Azorius Arrester	Creature
Azorius Charm	Instant
Azorius Guildgate	Land
Azorius Justiciar	Creature
Azorius Keyrune	Unknown
Azure Drake	Creature
Azure Mage	Creature
Back from the Brink	Unknown
Back to Nature	Instant
Bala Ged Scorpion	Creature
Bala Ged Thief	Creature
Balefire Dragon	Creature
Ball Lightning	Creature
Baloth Cage Trap	Instant
Baloth Woodcrasher	Creature
Bane of Hanweir	Creature
Baneful Omen	Unknown
Baneslayer Angel	Creature
Banishing Stroke	Instant
Banishment Decree	Instant
Banners Raised	Instant
Bar the Door	Instant
Barbed Battlegear	Unknown
Barony Vampire	Creature
Barrage Ogre	Creature
Barter in Blood	Sorcery
Batterhorn	Creature
Batterskull	Unknown
Battle-Rattle Shaman	Creature
Battle Hymn	Instant
Battle Rampart	Creature
Battle of Wits	Unknown
Battleflight Eagle	Creature
Battleground Geist	Creature
Bazaar Krovod	Creature
Bear Umbra	Unknown
Beast Hunt	Sorcery
Beast Within	Instant
Beastbreaker of Bala Ged	Creature
Beastmaster Ascension	Unknown
Beguiler of Wills	Creature
Bellowing Tanglewurm	Creature
Bellows Lizard	Creature
Belltower Sphinx	Creature
Benalish Veteran	Creature
Berserkers of Blood Ridge	Creature
Birds of Paradise	Creature
Bitterheart Witch	Creature
Black Cat	Creature
Black Knight	Creature
Blackcleave Cliffs	Land
Blackcleave Goblin	Creature
Blade-Tribe Berserkers	Creature
Blade Splicer	Creature
Blade of the Bloodchief	Unknown
Bladed Bracers	Unknown
Bladed Pinions	Unknown
Bladetusk Boar	Creature
Blasphemous Act	Sorcery
Blazing Torch	Unknown
Bleak Coven Vampires	Creature
Blessings of Nature	Sorcery
Blight Mamba	Creature
Blighted Agent	Creature
Blightwidow	Creature
Blind Zealot	Creature
Blinding Mage	Creature
Blistergrub	Creature
Blisterstick Shaman	Creature
Blood Artist	Creature
Blood Crypt	Land
Blood Feud	Sorcery
Blood Ogre	Creature
Blood Reckoning	Unknown
Blood Seeker	Creature
Blood Tithe	Sorcery
Blood Tribute	Sorcery
Bloodchief Ascension	Unknown
Bloodcrazed Goblin	Creature
Bloodcrazed Neonate	Creature
Bloodflow Connoisseur	Creature
Bloodfray Giant	Creature
Bloodghast	Creature
Bloodgift Demon	Creature
Bloodhunter Bat	Creature
Bloodline Keeper	Creature
Bloodlord of Vaasgoth	Creature
Bloodrage Vampire	Creature
Bloodrite Invoker	Creature
Bloodshot Trainee	Creature
Bloodthrone Vampire	Creature
Bludgeon Brawl	Unknown
Blunt the Assault	Instant
Blustersquall	Instant
Boar Umbra	Unknown
Bog Raiders	Creature
Bog Tatters	Creature
Bog Wraith	Creature
Bogardan Hellkite	Creature
Bold Defense	Instant
Bond Beetle	Creature
Bonds of Faith	Unknown
Bonds of Quicksilver	Unknown
Bone Splinters	Sorcery
Bone to Ash	Instant
Bonebreaker Giant	Creature
Bonehoard	Unknown
Boneyard Wurm	Creature
Borderland Ranger	Creature
Boundless Realms	Sorcery
Bountiful Harvest	Sorcery
Bower Passage	Unknown
Brain Weevil	Creature
Bramble Creeper	Creature
Bramblecrush	Sorcery
Bramblesnap	Creature
Brave the Elements	Instant
Break of Day	Instant
Briarpack Alpha	Creature
Brimstone Mage	Creature
Brimstone Volley	Instant
Brindle Boar	Creature
Brink of Disaster	Unknown
Brittle Effigy	Unknown
Brood Birthing	Sorcery
Broodwarden	Creature
Brushstrider	Creature
Brutalizer Exarch	Creature
Builder's Blessing	Unknown
Bump in the Night	Sorcery
Burden of Guilt	Unknown
Buried Ruin	Land
Burn at the Stake	Sorcery
Burn the Impure	Instant
Burning Inquiry	Sorcery
Burning Oil	Instant
Burning Vengeance	Unknown
Burst Lightning	Instant
Burst of Speed	Sorcery
Butcher Ghoul	Creature
Butcher's Cleaver	Unknown
Cackling Counterpart	Instant
Cadaver Imp	Creature
Caged Sun	Unknown
Call of the Conclave	Sorcery
Call to Mind	Sorcery
Call to Serve	Unknown
Call to the Grave	Unknown
Call to the Kindred	Unknown
Caller of Gales	Creature
Cancel	Instant
Canyon Minotaur	Creature
Capricious Efreet	Creature
Captain of the Mists	Creature
Captain of the Watch	Creature
Captain's Call	Sorcery
Captivating Vampire	Creature
Carapace Forger	Creature
Caravan Escort	Creature
Caravan Hurda	Creature
Caravan Vigil	Sorcery
Caress of Phyrexia	Sorcery
Carnage Altar	Unknown
Carnage Wurm	Creature
Carnifex Demon	Creature
Carnival Hellsteed	Creature
Carrion Call	Instant
Cast Through Time	Unknown
Catacomb Slug	Creature
Cathars' Crusade	Unknown
Cathedral Sanctifier	Creature
Cathedral of War	Land
Caustic Hound	Creature
Cavern of Souls	Land
Celestial Mantle	Unknown
Celestial Purge	Instant
Cellar Door	Unknown
Cemetery Reaper	Creature
Centaur Courser	Creature
Centaur Healer	Creature
Centaur's Herald	Creature
Cerebral Eruption	Sorcery
Chained Throatseeker	Creature
Chalice of Death	Unknown
Chalice of Life	Unknown
Champion of Lambholt	Creature
Champion of the Parish	Creature
Champion's Drake	Creature
Chancellor of the Annex	Creature
Chancellor of the Dross	Creature
Chancellor of the Forge	Creature
Chancellor of the Spires	Creature
Chancellor of the Tangle	Creature
Chandra's Fury	Instant
Chandra's Outrage	Instant
Chandra's Phoenix	Creature
Chandra's Spitfire	Creature
Chant of the Skifsang	Unknown
Chaos Imps	Creature
Chapel Geist	Creature
Charmbreaker Devils	Creature
Chasm Drake	Creature
Chemister's Trick	Instant
Child of Night	Creature
Chill of Foreboding	Sorcery
Choking Fumes	Instant
Chorus of Might	Instant
Chosen of Markov	Creature
Chromatic Lantern	Unknown
Chronic Flooding	Unknown
Circle of Flame	Unknown
Civic Saber	Unknown
Civilized Scholar	Creature
Claustrophobia	Unknown
Cleaver Riot	Sorcery
Cliff Threader	Creature
Clifftop Retreat	Land
Clinging Mists	Instant
Clock of Omens	Unknown
Cloistered Youth	Creature
Clone	Creature
Cloud Crusader	Creature
Cloud Elemental	Creature
Cloudshift	Instant
Coat of Arms	Unknown
Cobblebrute	Creature
Cobbled Wings	Unknown
Cobra Trap	Instant
Codex Shredder	Unknown
Collective Blessing	Unknown
Combust	Instant
Commander's Authority	Unknown
Common Bond	Instant
Concordia Pegasus	Creature
Concussive Bolt	Sorcery
Condemn	Instant
Conjured Currency	Unknown
Conjurer's Closet	Unknown
Conquering Manticore	Creature
Conqueror's Pledge	Sorcery
Consecrated Sphinx	Creature
Consume the Meek	Instant
Consuming Vapors	Sorcery
Contagion Clasp	Unknown
Contagion Engine	Unknown
Contagious Nim	Creature
Contaminated Ground	Unknown
Contested War Zone	Land
Conundrum Sphinx	Creature
Conversion Chamber	Unknown
Convincing Mirage	Unknown
Copper Carapace	Unknown
Copperhorn Scout	Creature
Copperline Gorge	Land
Coral Merfolk	Creature
Coralhelm Commander	Creature
Corpse Lunge	Instant
Corpse Traders	Creature
Corpsehatch	Sorcery
Corpsejack Menace	Creature
Corrupt	Sorcery
Corrupted Conscience	Unknown
Corrupted Harvester	Creature
Corrupted Resolve	Instant
Cosi's Trickster	Creature
Counterflux	Instant
Counterlash	Instant
Coursers' Accord	Sorcery
Courtly Provocateur	Creature
Cower in Fear	Instant
Crab Umbra	Unknown
Craterhoof Behemoth	Creature
Craterize	Sorcery
Craw Wurm	Creature
Creeping Corrosion	Sorcery
Creeping Renaissance	Sorcery
Cremate	Instant
Crimson Mage	Creature
Crimson Muckwader	Creature
Crippling Blight	Unknown
Crippling Chill	Instant
Crosstown Courier	Creature
Crossway Vampire	Creature
Crown of Empires	Unknown
Crusader of Odric	Creature
Crush	Instant
Crushing Vines	Instant
Crypt Creeper	Creature
Crypt Ripper	Creature
Crypt of Agadeem	Land
Cryptoplasm	Creature
Crystal Ball	Unknown
Cudgel Troll	Creature
Culling Dais	Unknown
Cultivate	Sorcery
Curiosity	Unknown
Curse of Bloodletting	Unknown
Curse of Death's Hold	Unknown
Curse of Echoes	Unknown
Curse of Exhaustion	Unknown
Curse of Misfortunes	Unknown
Curse of Oblivion	Unknown
Curse of Stalked Prey	Unknown
Curse of Thirst	Unknown
Curse of Wizardry	Unknown
Curse of the Bloody Tome	Unknown
Curse of the Nightly Hunt	Unknown
Curse of the Pierced Heart	Unknown
Cursebreak	Instant
Cyclonic Rift	Instant
Cyclops Gladiator	Creature
Cystbearer	Creature
Daggerback Basilisk	Creature
Daggerdrome Imp	Creature
Dangerous Wager	Instant
Dark Favor	Unknown
Dark Impostor	Creature
Dark Revenant	Creature
Dark Tutelage	Unknown
Darkslick Drake	Creature
Darkslick Shores	Land
Darksteel Axe	Unknown
Darksteel Plate	Unknown
Darksteel Relic	Unknown
Darkthicket Wolf	Creature
Dawnglare Invoker	Creature
Dawntreader Elk	Creature
Day of Judgment	Sorcery
Daybreak Ranger	Creature
Dead Reveler	Creature
Dead Weight	Unknown
Deadbridge Goliath	Creature
Deadeye Navigator	Creature
Deadly Allure	Sorcery
Deadly Recluse	Creature
Dearly Departed	Creature
Death-Hood Cobra	Creature
Death Cultist	Creature
Death's Caress	Sorcery
Death's Presence	Unknown
Deathless Angel	Creature
Deathmark	Sorcery
Deceiver Exarch	Creature
Decimator Web	Unknown
Defang	Unknown
Defensive Stance	Unknown
Defy Death	Sorcery
Delver of Secrets	Creature
Dementia Bat	Creature
Demolish	Sorcery
Demon of Death's Gate	Creature
Demon's Horn	Unknown
Demonic Appetite	Unknown
Demonic Rising	Unknown
Demonic Taskmaster	Creature
Demonlord of Ashmouth	Creature
Demonmail Hauberk	Unknown
Demystify	Instant
Deprive	Instant
Deranged Assistant	Creature
Deranged Outcast	Creature
Descendants' Path	Unknown
Descent into Madness	Unknown
Desecrated Earth	Sorcery
Desecration Demon	Creature
Desolate Lighthouse	Land
Desperate Ravings	Instant
Despise	Sorcery
Destroy the Evidence	Sorcery
Destructive Force	Sorcery
Detention Sphere	Unknown
Devastating Summons	Sorcery
Devastation Tide	Sorcery
Deviant Glee	Unknown
Devouring Swarm	Creature
Devout Chaplain	Creature
Devout Lightcaster	Creature
Diabolic Tutor	Sorcery
Diminish	Instant
Diregraf Captain	Creature
Diregraf Escort	Creature
Diregraf Ghoul	Creature
Disaster Radius	Sorcery
Disciple of Bolas	Creature
Disciple of Griselbrand	Creature
Disentomb	Sorcery
Disfigure	Instant
Disorient	Instant
Dispatch	Instant
Dispel	Instant
Dispense Justice	Instant
Disperse	Instant
Dissipate	Instant
Dissipation Field	Unknown
Distant Memories	Sorcery
Distortion Strike	Sorcery
Distress	Sorcery
Divination	Sorcery
Divine Favor	Unknown
Divine Offering	Instant
Divine Reckoning	Sorcery
Divine Verdict	Instant
Djinn of Wishes	Creature
Domestication	Unknown
Doom Blade	Instant
Doomed Traveler	Creature
Door to Nothingness	Unknown
Doorkeeper	Creature
Dormant Gomazoa	Creature
Doubling Chant	Sorcery
Downpour	Instant
Downsize	Instant
Dragon Hatchling	Creature
Dragon Whelp	Creature
Dragon's Claw	Unknown
Dragonskull Summit	Land
Drainpipe Vermin	Creature
Drake Umbra	Unknown
Dramatic Rescue	Instant
Dread Drone	Creature
Dread Slaver	Creature
Dread Warlock	Creature
Dreadbore	Sorcery
Dreadwaters	Sorcery
Dream Twist	Instant
Dreamstone Hedron	Unknown
Dreg Mangler	Creature
Drifting Shade	Creature
Driver of the Dead	Creature
Drogskol Captain	Creature
Drogskol Reaver	Creature
Dross Hopper	Creature
Drowned Catacomb	Land
Drudge Beetle	Creature
Drudge Skeletons	Creature
Druid's Deliverance	Instant
Druid's Familiar	Creature
Druidic Satchel	Unknown
Druids' Repository	Unknown
Dryad's Favor	Unknown
Dual Casting	Unknown
Due Respect	Instant
Dungeon Geists	Creature
Dungrove Elder	Creature
Duress	Sorcery
Duskdale Wurm	Creature
Duskhunter Bat	Creature
Duskmantle Prowler	Creature
Duty-Bound Dead	Creature
Dynacharge	Instant
Earth Servant	Creature
Eaten by Spiders	Instant
Echo Circlet	Unknown
Echo Mage	Creature
Eel Umbra	Unknown
Eland Umbra	Unknown
Elder Cathar	Creature
Elder of Laurels	Creature
Elderscale Wurm	Creature
Eldrazi Monument	Unknown
Eldrazi Temple	Land
Electrickery	Instant
Electropotence	Unknown
Elemental Appeal	Sorcery
Elgaud Inquisitor	Creature
Elgaud Shieldmate	Creature
Elite Inquisitor	Creature
Elite Vanguard	Creature
Elixir of Immortality	Unknown
Elvish Archdruid	Creature
Elvish Piper	Creature
Elvish Visionary	Creature
Emancipation Angel	Creature
Ember Hauler	Creature
Embersmith	Creature
Emerald Oryx	Creature
Emerge Unscathed	Instant
Emeria Angel	Creature
Emeria, the Sky Ruin	Land
Emrakul's Hatcher	Creature
Enclave Cryptologist	Creature
Encrust	Unknown
Endless Ranks of the Dead	Unknown
Engulfing Slagwurm	Creature
Enormous Baloth	Creature
Enslave	Unknown
Entangling Vines	Unknown
Entomber Exarch	Creature
Erase	Instant
Erdwal Ripper	Creature
Escaped Null	Creature
Essence Backlash	Instant
Essence Drain	Sorcery
Essence Feed	Sorcery
Essence Harvest	Sorcery
Essence Scatter	Instant
Essence of the Wild	Creature
Eternity Vessel	Unknown
Ethereal Armor	Unknown
Evernight Shade	Creature
Evil Presence	Unknown
Evil Twin	Creature
Evolving Wilds	Land
Exclusion Ritual	Unknown
Excommunicate	Sorcery
Executioner's Hood	Unknown
Expedition Map	Unknown
Explorer's Scope	Unknown
Explosive Impact	Instant
Explosive Revelation	Sorcery
Exquisite Blood	Unknown
Eyes in the Skies	Instant
Ezuri's Archers	Creature
Ezuri's Brigade	Creature
Fabricate	Sorcery
Faerie Impostor	Creature
Faerie Invaders	Creature
Faith's Reward	Instant
Faith's Shield	Instant
Faithless Looting	Sorcery
Falkenrath Aristocrat	Creature
Falkenrath Exterminator	Creature
Falkenrath Marauders	Creature
Falkenrath Noble	Creature
Falkenrath Torturer	Creature
Fall of the Gavel	Instant
Fallen Ferromancer	Creature
Fangren Marauder	Creature
Farbog Boneflinger	Creature
Farbog Explorer	Creature
Farseek	Sorcery
Fauna Shaman	Creature
Favor of the Woods	Unknown
Favorable Winds	Unknown
Feast of Blood	Sorcery
Feed the Pack	Unknown
Feeling of Dread	Instant
Felidar Sovereign	Creature
Fencing Ace	Creature
Feral Ridgewolf	Creature
Ferrovore	Creature
Fervent Cathar	Creature
Fervor	Unknown
Festerhide Boar	Creature
Fettergeist	Creature
Fiend Hunter	Creature
Fiend of the Shadows	Creature
Fiery Hellhound	Creature
Fire Elemental	Creature
Fire Servant	Creature
Firebreathing	Unknown
Firemind's Foresight	Instant
Fires of Undeath	Instant
Firewing Phoenix	Creature
Fissure Vent	Sorcery
Flame Slash	Sorcery
Flameblast Dragon	Creature
Flameborn Hellion	Creature
Flameborn Viron	Creature
Flames of the Firebrand	Sorcery
Flashfreeze	Instant
Flayer Husk	Unknown
Flayer of the Hatebound	Creature
Fleeting Distraction	Instant
Flensermite	Creature
Flesh-Eater Imp	Creature
Flesh Allergy	Sorcery
Flight	Unknown
Flight Spellbomb	Unknown
Fling	Instant
Flinthoof Boar	Creature
Flowering Lumberknot	Creature
Fog	Instant
Fog Bank	Creature
Forbidden Alchemy	Instant
Forced Worship	Unknown
Foresee	Sorcery
Forest	Basic Land
Forge Devil	Creature
Forked Bolt	Sorcery
Fortress Crab	Creature
Frantic Salvage	Instant
Fresh Meat	Instant
Frightful Delusion	Instant
Frontier Guide	Creature
Frost Breath	Instant
Frost Titan	Creature
Frostwind Invoker	Creature
Fuel for the Cause	Instant
Fulgent Distraction	Instant
Full Moon's Rise	Unknown
Fume Spitter	Creature
Fungal Sprouting	Sorcery
Furnace Celebration	Unknown
Furnace Scamp	Creature
Furnace Whelp	Creature
Furor of the Bitten	Unknown
Furyborn Hellkite	Creature
Gaea's Revenge	Creature
Gallows Warden	Creature
Gallows at Willow Hill	Unknown
Galvanic Alchemist	Creature
Galvanic Blast	Instant
Galvanoth	Creature
Gang of Devils	Creature
Gargoyle Castle	Land
Garruk's Companion	Creature
Garruk's Horde	Creature
Garruk's Packleader	Creature
Gatecreeper Vine	Creature
Gatekeeper of Malakir	Creature
Gather the Townsfolk	Sorcery
Gatstaf Howler	Creature
Gatstaf Shepherd	Creature
Gavony Ironwright	Creature
Gavony Township	Land
Geist-Honored Monk	Creature
Geist Snatch	Instant
Geist Trappers	Creature
Geistflame	Instant
Gem of Becoming	Unknown
Geosurge	Sorcery
Geralf's Messenger	Creature
Geralf's Mindcrusher	Creature
Geth's Verdict	Instant
Geyser Glider	Creature
Ghalma's Warden	Creature
Ghastly Haunting	Unknown
Ghost Quarter	Land
Ghostform	Sorcery
Ghostly Flicker	Instant
Ghostly Possession	Unknown
Ghostly Touch	Unknown
Ghoulcaller's Bell	Unknown
Ghoulcaller's Chant	Sorcery
Ghoulflesh	Unknown
Ghoulraiser	Creature
Ghoultree	Creature
Giant Growth	Instant
Giant Scorpion	Creature
Giant Spider	Creature
Gideon's Avenger	Creature
Gideon's Lawkeeper	Creature
Gigantiform	Unknown
Gigantomancer	Creature
Gilded Lotus	Unknown
Glacial Fortress	Land
Gladecover Scout	Creature
Glimmerpoint Stag	Creature
Glimmerpost	Land
Glint Hawk	Creature
Glint Hawk Idol	Unknown
Glissa's Courier	Creature
Glissa's Scorn	Instant
Glistener Elf	Creature
Glistening Oil	Unknown
Gloom Surgeon	Creature
Gloomhunter	Creature
Gloomwidow	Creature
Glorious Charge	Instant
Glory Seeker	Creature
Gnathosaur	Creature
Gnaw to the Bone	Instant
Go for the Throat	Instant
Gobbling Ooze	Creature
Goblin Arsonist	Creature
Goblin Artillery	Creature
Goblin Balloon Brigade	Creature
Goblin Bangchuckers	Creature
Goblin Battle Jester	Creature
Goblin Bushwhacker	Creature
Goblin Chieftain	Creature
Goblin Electromancer	Creature
Goblin Fireslinger	Creature
Goblin Gaveleer	Creature
Goblin Grenade	Sorcery
Goblin Guide	Creature
Goblin Piker	Creature
Goblin Rally	Sorcery
Goblin Ruinblaster	Creature
Goblin Shortcutter	Creature
Goblin Tunneler	Creature
Goblin War Paint	Unknown
Goblin Wardriver	Creature
Golden Urn	Unknown
Goldenglow Moth	Creature
Goldnight Commander	Creature
Goldnight Redeemer	Creature
Golem Foundry	Unknown
Golem's Heart	Unknown
Golgari Charm	Instant
Golgari Decoy	Creature
Golgari Guildgate	Land
Golgari Keyrune	Unknown
Gomazoa	Creature
Gore-House Chainwalker	Creature
Gore Vassal	Creature
Gorehorn Minotaurs	Creature
Gorgon Flail	Unknown
Grafdigger's Cage	Unknown
Grafted Exoskeleton	Unknown
Grand Abolisher	Creature
Grand Architect	Creature
Grappling Hook	Unknown
Grasp of Darkness	Instant
Grasp of Phantoms	Sorcery
Grave Betrayal	Unknown
Grave Bramble	Creature
Grave Exchange	Sorcery
Grave Titan	Creature
Gravecrawler	Creature
Gravedigger	Creature
Gravepurge	Instant
Gravetiller Wurm	Creature
Graveyard Shovel	Unknown
Gravitational Shift	Unknown
Gravity Well	Unknown
Graypelt Refuge	Land
Grazing Gladehart	Creature
Great Sable Stag	Creature
Greater Basilisk	Creature
Greatsword	Unknown
Greenhilt Trainee	Creature
Greenweaver Druid	Creature
Gremlin Mine	Unknown
Griffin Protector	Creature
Griffin Rider	Creature
Griffin Sentinel	Creature
Grim Affliction	Instant
Grim Backwoods	Land
Grim Discovery	Sorcery
Grim Flowering	Sorcery
Grim Lavamancer	Creature
Grim Roustabout	Creature
Grindclock	Unknown
Griptide	Instant
Grisly Salvage	Instant
Grizzled Outcasts	Creature
Grotag Siege-Runner	Creature
Ground Seal	Unknown
Grounded	Unknown
Grove of the Guardian	Land
Growth Spasm	Sorcery
Gruesome Deformity	Unknown
Gruesome Discovery	Sorcery
Gruesome Encore	Sorcery
Gryff Vanguard	Creature
Guard Duty	Unknown
Guard Gomazoa	Creature
Guardian Lions	Creature
Guardian Seraph	Creature
Guardians' Pledge	Instant
Guardians of Akrasa	Creature
Guild Feud	Unknown
Guise of Fire	Unknown
Gutter Grime	Unknown
Guttersnipe	Creature
Guul Draz Assassin	Creature
Guul Draz Specter	Creature
Guul Draz Vampire	Creature
Hada Spy Patrol	Creature
Hagra Crocodile	Creature
Hagra Diabolist	Creature
Halimar Wavewatch	Creature
Hallowed Fountain	Land
Halo Hunter	Creature
Halt Order	Instant
Hamlet Captain	Creature
Hamletback Goliath	Creature
Hand of Emrakul	Creature
Hand of the Praetors	Creature
Hanweir Lancer	Creature
Hanweir Watchkeep	Creature
Harbor Bandit	Creature
Harbor Serpent	Creature
Harm's Way	Instant
Harmless Assault	Instant
Harrow	Instant
Harrowing Journey	Sorcery
Harvest Pyre	Instant
Harvester of Souls	Creature
Haunted Fengraf	Land
Haunting Echoes	Sorcery
Havengul Lich	Creature
Havengul Runebinder	Creature
Havengul Skaab	Creature
Havengul Vampire	Creature
Havoc Festival	Unknown
Haze Frog	Creature
Headless Skaab	Creature
Healer of the Pride	Creature
Heartless Summoning	Unknown
Heartstabber Mosquito	Creature
Heavy Arbalest	Unknown
Heavy Mattock	Unknown
Heckling Fiends	Creature
Hedron-Field Purists	Creature
Hedron Crab	Creature
Hedron Matrix	Unknown
Heirs of Stromkirk	Creature
Hellcarver Demon	Creature
Hellfire Mongrel	Creature
Hellhole Flailer	Creature
Hellion Crucible	Land
Hellion Eruption	Sorcery
Hellkite Charger	Creature
Hellkite Igniter	Creature
Hellrider	Creature
Herald of War	Creature
Heretic's Punishment	Unknown
Hero of Bladehold	Creature
Hero of Oxid Ridge	Creature
Heroes' Reunion	Instant
Hideous End	Instant
Hideous Visage	Sorcery
Highborn Ghoul	Creature
Highland Berserker	Creature
Hinterland Harbor	Land
Hinterland Hermit	Creature
Hinterland Scourge	Creature
Hive Mind	Unknown
Hoard-Smelter Dragon	Creature
Hoarding Dragon	Creature
Hollowhenge Beast	Creature
Hollowhenge Scavenger	Creature
Hollowhenge Spirit	Creature
Holy Justiciar	Creature
Holy Strength	Unknown
Homicidal Brute	Creature
Homicidal Seclusion	Unknown
Honor of the Pure	Unknown
Horizon Spellbomb	Unknown
Horncaller's Chant	Sorcery
Horned Turtle	Creature
Hornet Sting	Instant
Horrifying Revelation	Sorcery
Hound of Griselbrand	Creature
Hover Barrier	Creature
Howl of the Night Pack	Sorcery
Howlgeist	Creature
Howling Banshee	Creature
Howling Mine	Unknown
Howlpack Alpha	Creature
Howlpack of Estwald	Creature
Human Frailty	Instant
Hunger of the Howlpack	Instant
Hunted Ghoul	Creature
Hunter's Insight	Instant
Hunters' Feast	Sorcery
Huntmaster of the Fells	Creature
Hussar Patrol	Creature
Hydrosurge	Instant
Hyena Umbra	Unknown
Hypersonic Dragon	Creature
Hypnotic Specter	Creature
Hysterical Blindness	Instant
Ice Cage	Unknown
Ichor Explosion	Sorcery
Ichor Rats	Creature
Ichor Wellspring	Unknown
Ignite Disorder	Instant
Ikiral Outrider	Creature
Illusionary Servant	Creature
Immerwolf	Creature
Impaler Shrike	Creature
Inaction Injunction	Sorcery
Incinerate	Instant
Incite	Instant
Increasing Ambition	Sorcery
Increasing Devotion	Sorcery
Increasing Savagery	Sorcery
Increasing Vengeance	Instant
Indestructibility	Unknown
Index	Sorcery
Indomitable Archangel	Creature
Induce Despair	Instant
Inexorable Tide	Unknown
Infantry Veteran	Creature
Infernal Plunge	Sorcery
Inferno Elemental	Creature
Inferno Titan	Creature
Inferno Trap	Instant
Infiltration Lens	Unknown
Infinite Reflection	Unknown
Inkmoth Nexus	Land
Inquisition of Kozilek	Sorcery
Inquisitor Exarch	Creature
Inquisitor's Flail	Unknown
Insectile Aberration	Creature
Inspiration	Instant
Inspired Charge	Instant
Instigator Gang	Creature
Instill Infection	Instant
Intangible Virtue	Unknown
Into the Core	Instant
Into the Maw of Hell	Sorcery
Into the Roil	Instant
Into the Void	Sorcery
Intrepid Hero	Creature
Invader Parasite	Creature
Invisible Stalker	Creature
Ior Ruin Expedition	Unknown
Ironfang	Creature
Irresistible Prey	Sorcery
Island	Basic Land
Isolated Chapel	Land
Isolation Cell	Unknown
Isperia's Skywatch	Creature
It That Betrays	Creature
Izzet Charm	Instant
Izzet Guildgate	Land
Izzet Keyrune	Unknown
Izzet Staticaster	Creature
Jace's Archivist	Creature
Jace's Erasure	Unknown
Jace's Ingenuity	Instant
Jace's Phantasm	Creature
Jackal Familiar	Creature
Jaddi Lifestrider	Creature
Jade Mage	Creature
Jar of Eyeballs	Unknown
Jarad's Orders	Sorcery
Jayemdae Tome	Unknown
Jinxed Idol	Unknown
Joint Assault	Instant
Joraga Bard	Creature
Joraga Treespeaker	Creature
Journey to Nowhere	Unknown
Jump	Instant
Jwar Isle Refuge	Land
Jwari Scuttler	Creature
Kabira Crossroads	Land
Kabira Evangel	Creature
Kabira Vindicator	Creature
Kalonian Behemoth	Creature
Kargan Dragonlord	Creature
Kazandu Blademaster	Creature
Kazandu Refuge	Land
Kazandu Tuskcaller	Creature
Kazuul Warlord	Creature
Keening Apparition	Creature
Keening Stone	Unknown
Kelinore Bat	Creature
Kemba's Legion	Creature
Kemba's Skyguard	Creature
Kessig Cagebreakers	Creature
Kessig Malcontents	Creature
Kessig Recluse	Creature
Kessig Wolf	Creature
Kessig Wolf Run	Land
Khalni Gem	Unknown
Khalni Heart Expedition	Unknown
Khalni Hydra	Creature
Kiln Fiend	Creature
Kindercatch	Creature
Kindled Fury	Instant
Kite Shield	Unknown
Kitesail	Unknown
Knight Exemplar	Creature
Knight of Cliffhaven	Creature
Knight of Glory	Creature
Knight of Infamy	Creature
Knightly Valor	Unknown
Knowledge Pool	Unknown
Kor Aeronaut	Creature
Kor Cartographer	Creature
Kor Duelist	Creature
Kor Hookmaster	Creature
Kor Line-Slinger	Creature
Kor Outfitter	Creature
Kor Sanctifiers	Creature
Kor Skyfisher	Creature
Kor Spiritdancer	Creature
Korozda Guildmage	Creature
Korozda Monitor	Creature
Koth's Courier	Creature
Kozilek's Predator	Creature
Kraken Hatchling	Creature
Kraken's Eye	Unknown
Krallenhorde Killer	Creature
Krallenhorde Wantons	Creature
Krenko's Command	Sorcery
Kruin Outlaw	Creature
Kruin Striker	Creature
Kuldotha Flamefiend	Creature
Kuldotha Phoenix	Creature
Kuldotha Rebirth	Sorcery
Kuldotha Ringleader	Creature
Laboratory Maniac	Creature
Lagac Lizard	Creature
Lair Delve	Sorcery
Lambholt Elder	Creature
Landbind Ritual	Sorcery
Lantern Spirit	Creature
Lashwrithe	Unknown
Last Kiss	Instant
Latch Seeker	Creature
Launch Party	Instant
Lava Axe	Sorcery
Lavaball Trap	Instant
Lavafume Invoker	Creature
Lay Bare	Instant
Lead the Stampede	Sorcery
Leaf Arrow	Instant
Leap of Faith	Instant
Leeching Bite	Instant
Leonin Arbiter	Creature
Leonin Relic-Warder	Creature
Leonin Skyhunter	Creature
Lethargy Trap	Instant
Levitation	Unknown
Leyline of Anticipation	Unknown
Leyline of Punishment	Unknown
Leyline of Sanctity	Unknown
Leyline of Vitality	Unknown
Leyline of the Void	Unknown
Liege of the Tangle	Creature
Life's Finale	Sorcery
Lifelink	Unknown
Lifesmith	Creature
Lighthouse Chronologist	Creature
Lightmine Field	Unknown
Lightning Bolt	Instant
Lightning Elemental	Creature
Lightning Mauler	Creature
Lightning Prowess	Unknown
Lightwielder Paladin	Creature
Liliana's Caress	Unknown
Liliana's Shade	Creature
Liliana's Specter	Creature
Lingering Souls	Sorcery
Liquimetal Coating	Unknown
Livewire Lash	Unknown
Living Destiny	Instant
Living Tsunami	Creature
Llanowar Elves	Creature
Lobber Crew	Creature
Lone Missionary	Creature
Lone Revenant	Creature
Looming Shade	Creature
Lord of Lineage	Creature
Lord of Shatterskull Pass	Creature
Lord of the Unreal	Creature
Lost Leonin	Creature
Lost in the Mist	Instant
Lost in the Woods	Unknown
Lotleth Troll	Creature
Lotus Cobra	Creature
Loxodon Convert	Creature
Loxodon Partisan	Creature
Loxodon Smiter	Creature
Loxodon Wayfarer	Creature
Loyal Cathar	Creature
Ludevic's Abomination	Creature
Ludevic's Test Subject	Creature
Lullmage Mentor	Creature
Lumberknot	Creature
Lumengrid Drake	Creature
Luminarch Ascension	Unknown
Luminous Wake	Unknown
Lunar Mystic	Creature
Lure	Unknown
Lurking Crocodile	Creature
Lurking Predators	Unknown
Lust for War	Unknown
Lux Cannon	Unknown
Lyev Skyknight	Creature
Maalfeld Twins	Creature
Mad Prophet	Creature
Magebane Armor	Unknown
Magma Phoenix	Creature
Magma Rift	Sorcery
Magmaw	Creature
Magnetic Mine	Unknown
Magosi, the Waterveil	Land
Make a Wish	Sorcery
Makeshift Mauler	Creature
Makindi Griffin	Creature
Makindi Shieldmate	Creature
Malakir Bloodwitch	Creature
Malicious Intent	Unknown
Malignus	Creature
Mammoth Umbra	Unknown
Mana Leak	Instant
Manabarbs	Unknown
Manalith	Unknown
Manic Vandal	Creature
Manor Skeleton	Creature
Maritime Guard	Creature
Mark of Mutiny	Sorcery
Mark of the Vampire	Unknown
Markov Blademaster	Creature
Markov Patrician	Creature
Markov Warlord	Creature
Markov's Servant	Creature
Marrow Bats	Creature
Marsh Casualties	Sorcery
Marsh Flats	Land
Martial Law	Unknown
Mask of Avacyn	Unknown
Mass Appeal	Sorcery
Mass Polymorph	Sorcery
Massacre Wurm	Creature
Master Splicer	Creature
Master Thief	Creature
Master of the Pearl Trident	Creature
Master of the Wild Hunt	Creature
Master's Call	Instant
Maul Splicer	Creature
Mausoleum Guard	Creature
Maw of the Mire	Sorcery
Mayor of Avabruck	Creature
Megrim	Unknown
Melira's Keepers	Creature
Melt Terrain	Sorcery
Memoricide	Sorcery
Memory's Journey	Instant
Mental Agony	Sorcery
Mentor of the Meek	Creature
Merciless Predator	Creature
Mercurial Chemister	Creature
Merfolk Looter	Creature
Merfolk Mesmerist	Creature
Merfolk Observer	Creature
Merfolk Seastalkers	Creature
Merfolk Skyscout	Creature
Merfolk Sovereign	Creature
Merfolk Spy	Creature
Merfolk Wayfinder	Creature
Merfolk of the Pearl Trident	Creature
Mesa Enchantress	Creature
Metallic Mastery	Sorcery
Midnight Duelist	Creature
Midnight Guard	Creature
Midnight Haunting	Instant
Midvast Protector	Creature
Might of Oaks	Instant
Might of the Masses	Instant
Mighty Leap	Instant
Mimic Vat	Unknown
Mind Control	Unknown
Mind Rot	Sorcery
Mind Sculpt	Sorcery
Mind Sludge	Sorcery
Mind Unbound	Unknown
Mindbreak Trap	Instant
Mindclaw Shaman	Creature
Mindcrank	Unknown
Mindculling	Sorcery
Mindless Null	Creature
Mindshrieker	Creature
Minotaur Aggressor	Creature
Mire Blight	Unknown
Mirran Crusader	Creature
Mirran Mettle	Instant
Mirran Spy	Creature
Mirror-Mad Phantasm	Creature
Mirror of Fate	Unknown
Mirrorworks	Unknown
Mist Leopard	Creature
Mist Raven	Creature
Misthollow Griffin	Creature
Misty Rainforest	Land
Mitotic Manipulation	Sorcery
Mitotic Slime	Creature
Mizzium Mortars	Sorcery
Mizzium Skin	Instant
Mnemonic Wall	Creature
Moan of the Unhallowed	Sorcery
Mogg Flunkies	Creature
Mold Adder	Creature
Mold Shambler	Creature
Molder Beast	Creature
Moldgraf Monstrosity	Creature
Molten Psyche	Sorcery
Molten Ravager	Creature
Moment of Heroism	Instant
Momentous Fall	Instant
Mondronen Shaman	Creature
Monomania	Sorcery
Moon Heron	Creature
Moonlight Geist	Creature
Moonmist	Instant
Moonscarred Werewolf	Creature
Moonsilver Spear	Unknown
Moonveil Dragon	Creature
Moorland Haunt	Land
Moorland Inquisitor	Creature
Morbid Plunder	Sorcery
Moriok Reaver	Creature
Morkrut Banshee	Creature
Mortarpod	Unknown
Mortician Beetle	Creature
Mortis Dogs	Creature
Mountain	Basic Land
Mul Daya Channelers	Creature
Mulch	Sorcery
Murasa Pyromancer	Creature
Murder	Instant
Murder of Crows	Creature
Mutilate	Sorcery
Mwonvuli Beast Tracker	Creature
Mycosynth Fiend	Creature
Mycosynth Wellspring	Unknown
Myr Reservoir	Unknown
Myr Turbine	Unknown
Myrsmith	Creature
Mystic Retrieval	Sorcery
Mystifying Maze	Land
Nantuko Shade	Creature
Narcolepsy	Unknown
Narrow Escape	Instant
Natural End	Instant
Naturalize	Instant
Nature's Spiral	Sorcery
Near-Death Experience	Unknown
Nearheath Pilgrim	Creature
Nearheath Stalker	Creature
Necrobite	Instant
Necrogen Censer	Unknown
Necrogen Scudder	Creature
Necropolis Regent	Creature
Necropouncer	Unknown
Necrotic Ooze	Creature
Necrotic Plague	Unknown
Needlebite Trap	Instant
Negate	Instant
Nema Siltlurker	Creature
Nephalia Drownyard	Land
Nephalia Seakite	Creature
Nephalia Smuggler	Creature
Nest Invader	Creature
Nested Ghoul	Creature
Nether Horror	Creature
Nettle Swine	Creature
Neurok Commando	Creature
Neurok Invisimancer	Creature
Nevermore	Unknown
New Prahv Guildmage	Creature
Niblis of the Breath	Creature
Niblis of the Mist	Creature
Niblis of the Urn	Creature
Night Revelers	Creature
Night Terrors	Sorcery
Nightbird's Clutches	Sorcery
Nightfall Predator	Creature
Nighthaze	Sorcery
Nightmare	Creature
Nightshade Peddler	Creature
Nightwing Shade	Creature
Nihil Spellbomb	Unknown
Nim Deathmantle	Unknown
Nimana Sell-Sword	Creature
Nimbus Wings	Unknown
Nirkana Cutthroat	Creature
Nirkana Revenant	Creature
Nissa's Chosen	Creature
Nivix Guildmage	Creature
Noble Vestige	Creature
Nomads' Assembly	Sorcery
Null Champion	Creature
Numbing Dose	Unknown
Oak Street Innkeeper	Creature
Oakenform	Unknown
Oblivion Ring	Unknown
Obsidian Fireheart	Creature
Obstinate Baloth	Creature
Oculus	Creature
Ogre Geargrabber	Creature
Ogre Jailbreaker	Creature
Ogre Menial	Creature
Ogre Resister	Creature
Ogre Sentry	Creature
Ogre's Cleaver	Unknown
Omen Machine	Unknown
Omniscience	Unknown
Ondu Cleric	Creature
Ondu Giant	Creature
Onyx Mage	Creature
Open the Vaults	Sorcery
Oracle of Mul Daya	Creature
Oran-Rief Recluse	Creature
Oran-Rief Survivalist	Creature
Oran-Rief, the Vastwood	Land
Orchard Spirit	Creature
Origin Spellbomb	Unknown
Otherworld Atlas	Unknown
Oust	Sorcery
Outwit	Instant
Overgrown Battlement	Creature
Overgrown Tomb	Land
Overrun	Sorcery
Overwhelming Stampede	Sorcery
Oxidda Daredevil	Creature
Oxidda Scrapmelter	Creature
Pacifism	Unknown
Pack Rat	Creature
Painful Quandary	Unknown
Painsmith	Creature
Palace Guard	Creature
Palisade Giant	Creature
Panic Attack	Sorcery
Panic Spellbomb	Unknown
Parallel Lives	Unknown
Paralyzing Grasp	Unknown
Paraselene	Sorcery
Parasitic Implant	Unknown
Past in Flames	Sorcery
Pathbreaker Wurm	Creature
Pathrazer of Ulamog	Creature
Pawn of Ulamog	Creature
Peel from Reality	Instant
Pelakka Wurm	Creature
Pennon Blade	Unknown
Peregrine Griffin	Creature
Perilous Shadow	Creature
Perish the Thought	Sorcery
Personal Sanctuary	Unknown
Pestilence Demon	Creature
Phantasmal Abomination	Creature
Phantasmal Bear	Creature
Phantasmal Dragon	Creature
Phantasmal Image	Creature
Phantom Beast	Creature
Phantom General	Creature
Phantom Warrior	Creature
Phylactery Lich	Creature
Phyresis	Unknown
Phyrexia's Core	Land
Phyrexian Crusader	Creature
Phyrexian Hydra	Creature
Phyrexian Ingester	Creature
Phyrexian Obliterator	Creature
Phyrexian Rager	Creature
Phyrexian Rebirth	Sorcery
Phyrexian Swarmlord	Creature
Phyrexian Unlife	Unknown
Phyrexian Vatmother	Creature
Pillar of Flame	Sorcery
Pillarfield Ox	Creature
Piranha Marsh	Land
Piston Sledge	Unknown
Pistus Strike	Instant
Pitchburn Devils	Creature
Pitfall Trap	Instant
Pithing Needle	Unknown
Plague Stinger	Creature
Plaguemaw Beast	Creature
Plains	Basic Land
Planar Cleansing	Sorcery
Plated Geopede	Creature
Plated Seastrider	Creature
Plummet	Instant
Polluted Dead	Creature
Polymorph	Sorcery
Ponder	Sorcery
Praetor's Counsel	Sorcery
Praetor's Grasp	Sorcery
Precinct Captain	Creature
Predator Ooze	Creature
Predator's Gambit	Unknown
Predatory Rampage	Sorcery
Predatory Urge	Unknown
Preordain	Sorcery
Prey Upon	Sorcery
Prey's Vengeance	Instant
Pride Guardian	Creature
Priest of Urabrask	Creature
Priests of Norn	Creature
Primal Bellow	Instant
Primal Cocoon	Unknown
Primal Huntbeast	Creature
Primal Surge	Sorcery
Primeval Titan	Creature
Pristine Talisman	Unknown
Prized Elephant	Creature
Prized Unicorn	Creature
Prodigal Pyromancer	Creature
Prophetic Prism	Unknown
Prototype Portal	Unknown
Psychic Barrier	Instant
Psychic Miasma	Sorcery
Psychic Spiral	Instant
Psychic Surgery	Unknown
Public Execution	Instant
Puncturing Light	Instant
Punishing Fire	Instant
Puresteel Paladin	Creature
Purify the Grave	Instant
Pursuit of Flight	Unknown
Putrefax	Creature
Pyreheart Wolf	Creature
Pyretic Ritual	Instant
Pyroclasm	Sorcery
Pyroconvergence	Unknown
Pyromancer Ascension	Unknown
Quag Sickness	Unknown
Quest for Ancient Secrets	Unknown
Quest for Pure Flame	Unknown
Quest for the Gemblades	Unknown
Quest for the Gravelord	Unknown
Quest for the Holy Relic	Unknown
Quicksilver Amulet	Unknown
Quicksilver Gargantuan	Creature
Quicksilver Geyser	Instant
Quilled Slagwurm	Creature
Quirion Dryad	Creature
Racecourse Fury	Unknown
Rage Nimbus	Creature
Rage Thrower	Creature
Raging Goblin	Creature
Raging Poltergeist	Creature
Raid Bombardment	Unknown
Rain of Blades	Instant
Rain of Thorns	Sorcery
Rakdos Charm	Instant
Rakdos Guildgate	Land
Rakdos Keyrune	Unknown
Rakdos Ragemutt	Creature
Rakdos Ringleader	Creature
Rakish Heir	Creature
Rally the Forces	Instant
Rally the Peasants	Instant
Rampaging Baloths	Creature
Rampaging Werewolf	Creature
Rampant Growth	Sorcery
Rancor	Unknown
Ranger's Guile	Instant
Ranger's Path	Sorcery
Rapacious One	Creature
Ratchet Bomb	Unknown
Ravager of the Fells	Creature
Ravenous Demon	Creature
Ravenous Rats	Creature
Ravenous Trap	Instant
Ray of Revelation	Instant
Razor Hippogriff	Creature
Razor Swine	Creature
Razorfoot Griffin	Creature
Razorverge Thicket	Land
Realms Uncharted	Instant
Reap the Seagraf	Sorcery
Reaper from the Abyss	Creature
Reaper of Sheoldred	Creature
Reassembling Skeleton	Creature
Rebuke	Instant
Reckless Brute	Creature
Reckless Scholar	Creature
Reckless Waif	Creature
Reclaim	Instant
Recurring Insight	Sorcery
Redirect	Instant
Reforge the Soul	Sorcery
Regenerate	Instant
Regress	Instant
Relentless Rats	Creature
Relentless Skaabs	Creature
Relic Crush	Instant
Relic Putrescence	Unknown
Reliquary Tower	Land
Remember the Fallen	Sorcery
Renegade Demon	Creature
Renegade Doppelganger	Creature
Repay in Kind	Sorcery
Repel the Darkness	Instant
Requiem Angel	Creature
Rest in Peace	Unknown
Restoration Angel	Creature
Revenge of the Hunted	Sorcery
Reverberate	Instant
Revive	Sorcery
Revoke Existence	Sorcery
Rewind	Instant
Rhox Faithmender	Creature
Rhox Pikemaster	Creature
Riddlesmith	Creature
Riders of Gavony	Creature
Righteous Authority	Unknown
Righteous Blow	Instant
Righteousness	Instant
Ring of Evos Isle	Unknown
Ring of Kalonia	Unknown
Ring of Thune	Unknown
Ring of Valkas	Unknown
Ring of Xathrid	Unknown
Riot Devils	Creature
Riot Ringleader	Creature
Rise from the Grave	Sorcery
Risen Sanctuary	Creature
Rite of Replication	Sorcery
Rite of Ruin	Sorcery
Rites of Flourishing	Unknown
Rites of Reaping	Sorcery
River Boa	Creature
Rix Maadi Guildmage	Creature
Roaring Primadox	Creature
Roc Egg	Creature
Rod of Ruin	Unknown
Rogue's Passage	Land
Roil Elemental	Creature
Rolling Temblor	Sorcery
Rooftop Storm	Unknown
Rootborn Defenses	Instant
Rootbound Crag	Land
Rot Wolf	Creature
Rotcrown Ghoul	Creature
Rotted Hystrix	Creature
Rotting Fensnake	Creature
Rotting Legion	Creature
Royal Assassin	Creature
Rubbleback Rhino	Creature
Ruinous Minotaur	Creature
Rummaging Goblin	Creature
Rune-Scarred Demon	Creature
Runechanter's Pike	Unknown
Runeclaw Bear	Creature
Runeflare Trap	Instant
Runewing	Creature
Runic Repetition	Sorcery
Rush of Blood	Instant
Russet Wolves	Creature
Rusted Relic	Unknown
Sacred Wolf	Creature
Sadistic Sacrament	Sorcery
Safe Passage	Instant
Sage Owl	Creature
Salvage Scout	Creature
Sanctuary Cat	Creature
Sands of Delirium	Unknown
Sangromancer	Creature
Sanguine Bond	Unknown
Savage Silhouette	Unknown
Savage Surge	Instant
Saving Grasp	Instant
Scalding Devil	Creature
Scalding Tarn	Land
Scepter of Empires	Unknown
Scorch the Fields	Sorcery
Scoria Elemental	Creature
Scorned Villager	Creature
Scourge Servant	Creature
Scourge of Geier Reach	Creature
Scrambleverse	Sorcery
Scrapdiver Serpent	Creature
Scrapskin Drake	Creature
Scrapyard Salvo	Sorcery
Screeching Bat	Creature
Screeching Silcaw	Creature
Screeching Skaab	Creature
Scroll Thief	Creature
Scroll of Avacyn	Unknown
Scroll of Griselbrand	Unknown
Scute Mob	Creature
Scythe Tiger	Creature
Sea Gate Loremaster	Creature
Sea Gate Oracle	Creature
Seachrome Coast	Land
Search Warrant	Sorcery
Search the City	Unknown
Searchlight Geist	Creature
Searing Spear	Instant
Seascape Aerialist	Creature
Second Guess	Instant
Secrets of the Dead	Unknown
Security Blockade	Unknown
See Beyond	Sorcery
Seek the Horizon	Sorcery
Seismic Shudder	Instant
Seismic Strike	Instant
Seize the Initiative	Instant
Sejiri Refuge	Land
Selesnya Charm	Instant
Selesnya Guildgate	Land
Selesnya Keyrune	Unknown
Selesnya Sentry	Creature
Selfless Cathar	Creature
Selhoff Occultist	Creature
Seller of Songbirds	Creature
Semblance Anvil	Unknown
Sengir Vampire	Creature
Sensor Splicer	Creature
Sensory Deprivation	Unknown
Sentinel Spider	Creature
Septic Rats	Creature
Seraph Sanctuary	Land
Seraph of Dawn	Creature
Serpent of the Endless Sea	Creature
Serpent's Gift	Instant
Serra Angel	Creature
Serra Ascendant	Creature
Serra Avatar	Creature
Serra Avenger	Creature
Serum Raker	Creature
Servant of Nefarox	Creature
Sever the Bloodline	Sorcery
Sewer Shambler	Creature
Shape Anew	Sorcery
Shared Discovery	Sorcery
Sharpened Pitchfork	Unknown
Shatter	Instant
Shattered Angel	Creature
Shattered Perception	Sorcery
Shatterskull Giant	Creature
Sheltering Word	Instant
Shepherd of the Lost	Creature
Shieldmate's Blessing	Instant
Shimian Specter	Creature
Shimmering Grotto	Land
Shiv's Embrace	Unknown
Shivan Dragon	Creature
Shoal Serpent	Creature
Shock	Instant
Show of Valor	Instant
Shriek Raptor	Creature
Shriekgeist	Creature
Shriekhorn	Unknown
Shrieking Affliction	Unknown
Shrine of Boundless Growth	Unknown
Shrine of Burning Rage	Unknown
Shrine of Limitless Power	Unknown
Shrine of Loyal Legions	Unknown
Shrine of Piercing Vision	Unknown
Shrivel	Sorcery
Sickleslicer	Unknown
Siege-Gang Commander	Creature
Siege Mastodon	Creature
Sightless Ghoul	Creature
Sign in Blood	Sorcery
Silence	Instant
Silent Departure	Sorcery
Silklash Spider	Creature
Silver-Inlaid Dagger	Unknown
Silverblade Paladin	Creature
Silverchase Fox	Creature
Silverclaw Griffin	Creature
Silvercoat Lion	Creature
Silverpelt Werewolf	Creature
Silverskin Armor	Unknown
Skaab Goliath	Creature
Skaab Ruinator	Creature
Skeletal Grimace	Unknown
Skeletal Wurm	Creature
Skillful Lunge	Instant
Skinrender	Creature
Skinshifter	Creature
Skinwing	Unknown
Skirsdag Cultist	Creature
Skirsdag Flayer	Creature
Skirsdag High Priest	Creature
Skull Rend	Sorcery
Sky-Eel School	Creature
Sky Ruin Drake	Creature
Skyline Predator	Creature
Skymark Roc	Creature
Skywatcher Adept	Creature
Skywinder Drake	Creature
Slag Fiend	Creature
Slagstorm	Sorcery
Slaughter Cry	Instant
Slaughter Games	Sorcery
Slayer of the Wicked	Creature
Slayers' Stronghold	Land
Sleep	Sorcery
Slice in Twain	Instant
Sluiceway Scorpion	Creature
Slum Reaper	Creature
Slumbering Dragon	Creature
Smallpox	Sorcery
Smelt	Instant
Smite	Instant
Smite the Monstrous	Instant
Snake Umbra	Unknown
Snapcaster Mage	Creature
Snapping Drake	Creature
Snare the Skies	Instant
Soaring Seacliff	Land
Solemn Offering	Sorcery
Somberwald Dryad	Creature
Somberwald Sage	Creature
Somberwald Spider	Creature
Somberwald Vigilante	Creature
Sorcerer's Strongbox	Unknown
Sorin's Thirst	Instant
Sorin's Vengeance	Sorcery
Soul Bleed	Unknown
Soul Conduit	Unknown
Soul Parry	Instant
Soul Seizer	Creature
Soul Stair Expedition	Unknown
Soul Tithe	Unknown
Soul Warden	Creature
Soul of the Harvest	Creature
Soul's Attendant	Creature
Soulbound Guardians	Creature
Soulcage Fiend	Creature
Soulsurge Elemental	Creature
Soulsworn Spirit	Creature
Spare from Evil	Instant
Sparkmage Apprentice	Creature
Spawn of Rix Maadi	Creature
Spawning Breath	Instant
Spawnsire of Ulamog	Creature
Spectral Flight	Unknown
Spectral Gateguards	Creature
Spectral Prison	Unknown
Spectral Rider	Creature
Spell Pierce	Instant
Spellbook	Unknown
Spelltwine	Sorcery
Sphere of Safety	Unknown
Sphere of the Suns	Unknown
Sphinx-Bone Wand	Unknown
Sphinx Ambassador	Creature
Sphinx of Jwar Isle	Creature
Sphinx of Lost Truths	Creature
Sphinx of Magosi	Creature
Sphinx of Uthuun	Creature
Sphinx of the Chimes	Creature
Spider Spawning	Sorcery
Spider Umbra	Unknown
Spidersilk Net	Unknown
Spidery Grasp	Instant
Spiked Baloth	Creature
Spikeshot Elder	Creature
Spine of Ish Sah	Unknown
Spinebiter	Creature
Spined Wurm	Creature
Spiraling Duelist	Creature
Spire Barrage	Sorcery
Spire Monitor	Creature
Spire Serpent	Creature
Spirit Away	Unknown
Spirit Mantle	Unknown
Spiteful Shadows	Unknown
Splatter Thug	Creature
Splinter Twin	Unknown
Splinterfright	Creature
Sporecap Spider	Creature
Spread the Sickness	Sorcery
Spreading Seas	Unknown
Squadron Hawk	Creature
Stab Wound	Unknown
Stabbing Pain	Instant
Staff of Nin	Unknown
Staggershock	Instant
Stalking Vampire	Creature
Stalwart Shield-Bearers	Creature
Stampeding Rhino	Creature
Stave Off	Instant
Steady Progress	Instant
Stealer of Secrets	Creature
Steam Vents	Land
Steel Sabotage	Instant
Stensia Bloodhall	Land
Steppe Lynx	Creature
Stern Mentor	Creature
Stingerfling Spider	Creature
Stitched Drake	Creature
Stitcher's Apprentice	Creature
Stoic Rebuttal	Instant
Stolen Goods	Sorcery
Stomper Cub	Creature
Stone Giant	Creature
Stonefare Crocodile	Creature
Stonehorn Dignitary	Creature
Stonewright	Creature
Stony Silence	Unknown
Stormblood Berserker	Creature
Stormbound Geist	Creature
Stormfront Pegasus	Creature
Stormtide Leviathan	Creature
Strandwalker	Unknown
Strangleroot Geist	Creature
Strata Scythe	Unknown
Strider Harness	Unknown
Stromkirk Captain	Creature
Stromkirk Noble	Creature
Stromkirk Patrol	Creature
Student of Warfare	Creature
Sturmgeist	Creature
Sublime Archangel	Creature
Sudden Disappearance	Sorcery
Sulfur Falls	Land
Summoner's Bane	Instant
Summoning Trap	Instant
Sun Titan	Creature
Sunblast Angel	Creature
Sundial of the Infinite	Unknown
Sunpetal Grove	Land
Sunspear Shikari	Creature
Sunspire Griffin	Creature
Sunspring Expedition	Unknown
Supreme Verdict	Sorcery
Surge Node	Unknown
Surrakar Marauder	Creature
Surrakar Spellblade	Creature
Surreal Memoir	Sorcery
Survey the Wreckage	Sorcery
Survival Cache	Sorcery
Suture Priest	Creature
Sutured Ghoul	Creature
Swamp	Basic Land
Swift Justice	Instant
Swiftfoot Boots	Unknown
Switcheroo	Sorcery
Sword of Body and Mind	Unknown
Sword of Feast and Famine	Unknown
Sword of Vengeance	Unknown
Sword of War and Peace	Unknown
Sylvan Ranger	Creature
Sylvok Lifestaff	Unknown
SÃ©ance	Unknown
Tablet of the Guilds	Unknown
Tainted Strike	Instant
Tajuru Archer	Creature
Tajuru Preserver	Creature
Talons of Falkenrath	Unknown
Talrand's Invocation	Sorcery
Tandem Lookout	Creature
Tangle Angler	Creature
Tangle Mantis	Creature
Tanglesap	Instant
Taste of Blood	Sorcery
Tavern Swindler	Creature
Tectonic Rift	Sorcery
Teetering Peaks	Land
Tel-Jilad Defiance	Instant
Tel-Jilad Fallen	Creature
Telepathy	Unknown
Teleportal	Sorcery
Tempered Steel	Unknown
Tempest Owl	Creature
Tempest of Light	Instant
Temple Bell	Unknown
Temple Garden	Land
Temporal Mastery	Sorcery
Tendrils of Corruption	Instant
Tenement Crasher	Creature
Terminus	Sorcery
Terra Stomper	Creature
Terramorphic Expanse	Land
Terrifying Presence	Instant
Territorial Baloth	Creature
Terror of Kruin Pass	Creature
Terrus Wurm	Creature
Thatcher Revolt	Sorcery
Think Twice	Instant
Thought Gorger	Creature
Thought Scour	Instant
Thoughtflare	Instant
Thraben Doomsayer	Creature
Thraben Heretic	Creature
Thraben Militia	Creature
Thraben Purebloods	Creature
Thraben Sentry	Creature
Thraben Valiant	Creature
Thragtusk	Creature
Thrill-Kill Assassin	Creature
Throne of Empires	Unknown
Throne of Geth	Unknown
Thrummingbird	Creature
Thunder Strike	Instant
Thunderbolt	Instant
Thundermaw Hellkite	Creature
Thunderous Wrath	Instant
Timberland Guide	Creature
Timbermaw Larva	Creature
Timberpack Wolf	Creature
Time Reversal	Sorcery
Time Warp	Sorcery
Time of Heroes	Unknown
Timely Reinforcements	Sorcery
Tine Shrike	Creature
Tireless Missionaries	Creature
Titan Forge	Unknown
Titanic Growth	Instant
Tome Scour	Sorcery
Torch Fiend	Creature
Torch Slinger	Creature
Tormented Pariah	Creature
Tormented Soul	Creature
Tormentor Exarch	Creature
Tormentor's Trident	Unknown
Tormod's Crypt	Unknown
Torpor Orb	Unknown
Totem-Guide Hartebeest	Creature
Touch of the Eternal	Unknown
Tovolar's Magehunter	Creature
Tower Drake	Creature
Tower Geist	Creature
Tower of Calamities	Unknown
Towering Indrik	Creature
Toxic Nim	Creature
Tracker's Instincts	Sorcery
Trading Post	Unknown
Tragic Slip	Instant
Trailblazer's Boots	Unknown
Trained Caracal	Creature
Training Grounds	Unknown
Traitorous Blood	Sorcery
Traitorous Instinct	Sorcery
Transcendent Master	Creature
Transguild Promenade	Land
Trapfinder's Trick	Sorcery
Trapmaker's Snare	Instant
Traumatize	Sorcery
Travel Preparations	Sorcery
Traveler's Amulet	Unknown
Treacherous Pit-Dweller	Creature
Treasure Mage	Creature
Treasured Find	Sorcery
Tree of Redemption	Creature
Trepanation Blade	Unknown
Trestle Troll	Creature
Tribute to Hunger	Instant
Tricks of the Trade	Unknown
Trigon of Corruption	Unknown
Trigon of Infestation	Unknown
Trigon of Mending	Unknown
Trigon of Rage	Unknown
Trigon of Thought	Unknown
Trinket Mage	Creature
Triumph of Cruelty	Unknown
Triumph of Ferocity	Unknown
Triumph of the Hordes	Sorcery
Trollhide	Unknown
Trostani's Judgment	Instant
True Conviction	Unknown
Trumpet Blast	Instant
Trusted Forcemage	Creature
Trusty Machete	Unknown
Tuktuk Grunts	Creature
Tumble Magnet	Unknown
Tunnel Ignus	Creature
Turn Aside	Instant
Turn the Tide	Instant
Turn to Frog	Instant
Turn to Slag	Sorcery
Turntimber Basilisk	Creature
Turntimber Grove	Land
Turntimber Ranger	Creature
Twincast	Instant
Twisted Image	Instant
Typhoid Rats	Creature
Tyrant of Discord	Creature
Ulamog's Crusher	Creature
Ultimate Price	Instant
Ulvenwald Bear	Creature
Ulvenwald Mystics	Creature
Ulvenwald Primordials	Creature
Ulvenwald Tracker	Creature
Umara Raptor	Creature
Umbra Mystic	Creature
Unbreathing Horde	Creature
Unburial Rites	Sorcery
Uncanny Speed	Instant
Undead Alchemist	Creature
Undead Executioner	Creature
Undead Slayer	Creature
Underworld Connections	Unknown
Underworld Dreams	Unknown
Undying Evil	Instant
Unhallowed Cathar	Creature
Unhallowed Pact	Unknown
Unholy Fiend	Creature
Unholy Strength	Unknown
Unified Will	Instant
Unnatural Predation	Instant
Unruly Mob	Creature
Unstable Footing	Instant
Unsummon	Instant
Unwinding Clock	Unknown
Urban Burgeoning	Unknown
Urgent Exorcism	Instant
Utvara Hellkite	Creature
Valakut Fireboar	Creature
Valakut, the Molten Pinnacle	Land
Vampire Aristocrat	Creature
Vampire Hexmage	Creature
Vampire Interloper	Creature
Vampire Lacerator	Creature
Vampire Nighthawk	Creature
Vampire Nocturnus	Creature
Vampire Outcasts	Creature
Vampire's Bite	Instant
Vampiric Fury	Instant
Vandalblast	Sorcery
Vanguard's Shield	Unknown
Vanishment	Instant
Vapor Snag	Instant
Vastwood Gorger	Creature
Vault Skyward	Instant
Vault of the Archangel	Land
Vedalken Anatomist	Creature
Vedalken Certarch	Creature
Vedalken Entrancer	Creature
Vedalken Infuser	Creature
Veilborn Ghoul	Creature
Vendetta	Instant
Venerated Teacher	Creature
Vengeful Archon	Creature
Vengeful Pharaoh	Creature
Vengeful Vampire	Creature
Vengevine	Creature
Venser's Journal	Unknown
Vent Sentinel	Creature
Verdant Catacombs	Land
Vessel of Endless Rest	Unknown
Veteran Armorsmith	Creature
Veteran Swordsmith	Creature
Vexing Devil	Creature
Viashino Racketeer	Creature
Viashino Spearhunter	Creature
Victim of Night	Instant
Victorious Destruction	Sorcery
Victory's Herald	Creature
Vigil for the Lost	Unknown
Vigilante Justice	Unknown
Vile Rebirth	Instant
Village Bell-Ringer	Creature
Village Cannibals	Creature
Village Ironsmith	Creature
Village Survivors	Creature
Villagers of Estwald	Creature
Vines of Vastwood	Instant
Viral Drake	Creature
Viridian Betrayers	Creature
Viridian Claw	Unknown
Viridian Corrupter	Creature
Viridian Emissary	Creature
Viridian Harvest	Unknown
Viridian Revel	Unknown
Virulent Swipe	Instant
Virulent Wound	Instant
Viscera Seer	Creature
Visions of Beyond	Instant
Vital Splicer	Creature
Vitu-Ghazi Guildmage	Creature
Vivisection	Sorcery
Voice of the Provinces	Creature
Voiceless Spirit	Creature
Void Stalker	Creature
Voidwielder	Creature
Volcanic Dragon	Creature
Volcanic Strength	Unknown
Volition Reins	Unknown
Volt Charge	Instant
Voltaic Key	Unknown
Vorapede	Creature
Vorstclaw	Creature
Vulshok Berserker	Creature
Vulshok Heartstoker	Creature
Vulshok Refugee	Creature
Wakedancer	Creature
Walking Corpse	Creature
Wall of Bone	Creature
Wall of Faith	Creature
Wall of Fire	Creature
Wall of Frost	Creature
Wall of Omens	Creature
Wall of Torches	Creature
Wall of Vines	Creature
Wandering Wolf	Creature
War Falcon	Creature
War Priest of Thune	Creature
War Report	Instant
Warclamp Mastiff	Creature
Warden of the Wall	Unknown
Warlord's Axe	Unknown
Warmonger's Chariot	Unknown
Warp World	Sorcery
Warpath Ghoul	Creature
Warren Instigator	Creature
Warstorm Surge	Unknown
Water Servant	Creature
Watercourser	Creature
Wayfaring Temple	Creature
Weakness	Unknown
Welkin Tern	Creature
Werewolf Ransacker	Creature
Whipflare	Sorcery
Whiplash Trap	Instant
Whispering Specter	Creature
Whispersilk Cloak	Unknown
White Knight	Creature
Whitesun's Passage	Instant
Wild Beastmaster	Creature
Wild Defiance	Unknown
Wild Evocation	Unknown
Wild Griffin	Creature
Wild Guess	Sorcery
Wild Hunger	Instant
Wildblood Pack	Creature
Wildheart Invoker	Creature
Wildwood Geist	Creature
Wind Drake	Creature
Windborne Charge	Sorcery
Windrider Eel	Creature
Wing Puncture	Instant
Wing Splicer	Creature
Wingcrafter	Creature
Wit's End	Sorcery
Witchbane Orb	Unknown
Withstand Death	Instant
Wolfbitten Captive	Creature
Wolfhunter's Quiver	Unknown
Wolfir Avenger	Creature
Wolfir Silverheart	Creature
Wooden Stake	Unknown
Woodland Cemetery	Land
Woodland Sleuth	Creature
World Queller	Creature
World at War	Sorcery
Worldfire	Sorcery
Worldslayer	Unknown
Worldspine Wurm	Creature
Wrack with Madness	Sorcery
Wrap in Flames	Sorcery
Wreath of Geists	Unknown
Wring Flesh	Instant
Wurm's Tooth	Unknown
Xathrid Demon	Creature
Xathrid Gorgon	Creature
Xenograft	Unknown
Yavimaya Wurm	Creature
Yawning Fissure	Sorcery
Yeva's Forcemage	Creature
Yew Spirit	Creature
Young Wolf	Creature
Zanikev Locust	Creature
Zealous Conscripts	Creature
Zealous Strike	Instant
Zektar Shrine Expedition	Unknown
Zendikar Farguide	Creature
Zephyr Sprite	Creature
Zof Shade	Creature
Zombie Apocalypse	Sorcery
Zombie Goliath	Creature
Zombie Infestation	Unknown
Zulaport Enforcer	Creature
Ã†ther Adept	Creature
Ã†ther Figment	Creature
